8 43
###########################################
#1..******#..***.**..#.......#...*******..#
#.**###**###.#.###***###**##.##***#*.#*##.#
#*#..**....***..?...****..##....***.###*#.#
#.##***##**#.#*##***##**#.##**##****###*.*#
#.##***#..***#..***..**..*#..*##*##*****.##
#*.......#*#..*#..*......*.*#*****##****.2#
###########################################
