17 17
#################
#1..*****..**...#
#.*##**##**.*##.#
#**.########*..*#
#**####**#*####*#
#**###.?.***###*#
#*##..*###.*.##*#
##..*#*###*##.*##
#*.#.**###**.#*.#
#*###***..**###.#
#.*###***#*####.#
#*...#########.*#
#**####**#*###.*#
#**###...***##.*#
#.*##*###**.***.#
#..**.****.***.2#
#################