7 17
#################
#1..............#
#...*...........#
#......?........#
#..........*....#
#..............2#
#################